18 18 18 18 18 18 18 18 18 18 18 18 18 18 18 18 18 18 18 18 18 18 18 18 18 18 18 18 18 18 18 18 18 18 18 18 18 18 18 18 18 18 18 18 18 18 18 18 18 18 
18 18 18 18 18 18 18 18 18 18 18 18 18 18 18 18 18 18 18 18 18 18 18 18 18 18 18 18 18 18 18 18 18 18 18 18 18 18 18 18 18 18 18 18 18 18 18 18 18 18 
18 18 18 18 18 18 18 18 18 18 18 18 18 18 18 18 18 18 18 18 18 18 18 18 18 18 18 18 18 18 18 18 18 18 18 18 18 18 18 18 18 18 18 18 18 18 18 18 18 18 
18 18 18 18 18 18 18 18 18 18 18 18 18 18 18 18 18 18 18 18 18 18 18 18 18 18 18 18 18 18 18 18 18 18 18 18 18 18 18 18 18 18 18 18 18 18 18 18 18 18 
18 18 18 18 18 18 18 18 18 18 18 18 18 18 18 18 18 18 18 18 18 18 18 18 18 18 18 18 18 18 18 18 18 18 18 18 18 18 18 18 18 18 18 18 18 18 18 18 18 18 
18 18 18 18 18 18 18 18 18 18 18 18 18 18 18 18 18 18 18 18 18 18 18 18 18 18 18 18 18 18 18 18 18 18 18 18 18 18 18 18 18 18 18 18 18 18 18 18 18 18 
18 18 18 18 18 18 18 18 18 18 18 18 18 18 18 18 18 18 18 18 18 18 18 18 18 18 18 18 18 18 18 18 18 18 18 18 18 18 18 18 18 18 18 18 18 18 18 18 18 18 
18 18 18 18 18 18 18 18 18 18 18 18 18 18 18 18 18 18 18 18 18 18 18 18 18 18 18 18 18 18 18 18 18 18 18 18 18 18 18 18 18 18 18 18 18 18 18 18 18 18 
18 18 18 18 18 18 18 18 18 18 18 18 18 18 18 18 18 18 18 18 18 18 18 18 18 18 18 18 18 18 18 18 18 18 18 18 18 18 18 18 18 18 18 18 18 18 18 18 18 18 
18 18 18 18 18 18 18 18 18 18 18 18 18 18 18 18 18 18 18 18 18 18 18 18 18 18 18 18 18 18 18 18 18 18 18 18 18 18 18 18 18 18 18 18 18 18 18 18 18 18 
18 18 18 18 18 18 18 18 18 18 18 18 18 18 18 18 18 18 18 18 18 18 18 18 18 18 18 18 18 18 18 18 18 18 18 18 18 18 18 18 18 18 18 18 18 18 18 18 18 18 
18 18 18 18 18 18 18 18 18 18 18 18 18 18 18 18 18 18 18 18 18 18 18 18 18 18 18 18 18 18 18 18 18 18 18 18 18 18 18 18 18 18 18 18 18 18 18 18 18 18 
18 18 18 18 18 18 18 18 18 18 18 18 18 18 18 18 18 18 18 18 18 18 18 18 18 18 18 18 18 18 18 18 18 18 18 18 18 18 18 18 18 18 18 18 18 18 18 18 18 18 
18 18 18 18 18 18 18 18 18 18 18 18 18 18 18 18 18 18 18 18 18 18 18 18 18 18 18 18 18 18 18 18 18 18 18 18 18 18 18 18 18 18 18 18 18 18 18 18 18 18 
18 18 18 18 18 18 18 18 18 18 18 18 18 18 18 18 18 18 18 18 18 18 18 18 18 18 18 18 18 18 18 18 18 18 18 18 18 18 18 18 18 18 18 18 18 18 18 18 18 18 
18 18 18 18 18 18 18 18 18 18 18 28 26 26 26 26 26 26 26 26 26 26 26 26 26 26 26 26 26 26 26 26 26 26 26 29 18 18 18 18 18 18 18 18 18 18 18 18 18 18 
18 18 18 18 18 18 18 18 18 28 26 27 1 1 1 1 1 1 1 1 1 1 1 1 1 1 1 1 1 1 1 1 1 1 1 25 26 29 18 18 18 18 18 18 18 18 18 18 18 18 
18 18 18 18 18 18 18 18 18 24 1 1 1 1 1 1 1 1 1 1 1 1 1 1 1 1 1 1 1 32 32 32 32 32 32 1 1 25 29 18 18 18 18 18 18 18 18 18 18 18 
18 18 18 18 18 18 18 18 28 27 1 1 1 1 1 1 20 21 21 22 1 1 1 1 1 1 1 1 1 32 17 17 17 17 32 1 1 1 25 26 29 18 18 18 18 18 18 18 18 18 
18 18 18 18 18 18 18 18 24 1 1 1 1 20 21 21 31 18 18 30 22 1 1 1 1 1 1 1 1 17 17 17 37 17 32 1 1 1 1 1 25 26 29 18 18 18 18 18 18 18 
18 18 18 18 18 18 18 18 24 1 1 1 1 23 18 18 18 18 18 18 30 22 1 1 1 1 1 1 1 32 17 17 17 17 32 1 1 1 1 1 1 1 25 26 29 18 18 18 18 18 
18 18 18 18 18 18 18 18 24 1 1 1 20 31 18 18 18 18 18 18 28 27 1 1 1 1 1 1 1 32 32 32 32 32 32 16 1 1 1 1 1 1 1 1 23 18 18 18 18 18 
18 18 18 18 18 18 18 18 24 1 1 1 25 29 18 18 18 18 18 28 27 1 1 1 1 16 16 16 16 16 16 16 16 16 16 16 16 1 1 1 1 1 1 1 25 26 29 18 18 18 
18 18 18 18 18 18 18 28 27 1 1 1 1 25 26 29 18 18 28 27 1 1 1 1 16 16 16 16 16 16 16 16 16 16 16 16 16 16 16 1 1 1 1 1 1 1 23 18 18 18 
18 18 18 18 18 18 18 24 1 1 1 1 1 1 1 25 26 26 27 1 1 1 16 16 16 16 16 16 16 16 16 16 16 16 16 16 16 16 16 16 1 1 1 1 1 1 23 18 18 18 
18 18 18 18 18 18 18 24 1 1 1 1 1 1 1 1 1 1 1 1 1 16 16 16 16 16 16 1 1 1 16 16 1 1 1 16 16 16 16 16 16 1 1 1 1 1 23 18 18 18 
18 18 18 18 18 18 18 24 1 1 1 1 1 1 1 1 1 12 10 10 10 13 16 16 16 16 16 1 1 1 1 1 1 16 16 16 16 16 16 16 16 16 1 1 1 1 23 18 18 18 
18 18 18 18 18 18 18 24 1 12 10 10 10 10 10 10 10 11 3 3 3 7 1 1 1 1 1 1 1 1 1 1 1 1 1 16 16 16 16 16 16 1 1 1 1 1 23 18 18 18 
18 18 18 18 18 18 18 24 1 8 3 3 3 3 3 3 3 3 3 4 5 15 16 16 16 16 16 16 1 1 1 16 16 16 1 1 16 16 16 16 1 1 1 1 1 1 23 18 18 18 
18 18 18 18 18 18 18 24 1 14 5 5 5 5 6 3 4 5 5 15 1 1 16 16 16 16 16 16 16 16 16 16 16 16 16 1 1 1 1 1 1 16 1 1 1 1 23 18 18 18 
18 18 18 18 18 18 18 24 1 1 1 1 1 1 8 3 7 1 1 1 1 1 1 1 16 16 16 16 16 16 16 1 1 16 16 1 16 16 16 16 16 16 1 1 1 1 23 18 18 18 
18 18 18 18 18 18 18 24 1 1 1 1 1 1 8 3 7 1 1 1 1 1 1 1 1 16 16 16 16 33 1 1 1 1 1 1 16 16 16 16 16 1 1 1 1 20 31 18 18 18 
18 18 18 18 18 18 18 24 1 1 1 1 1 1 8 3 7 1 1 1 1 1 1 1 16 16 16 16 16 16 1 1 1 1 16 16 16 16 16 16 1 1 1 1 1 23 18 18 18 18 
18 18 18 18 18 18 18 24 1 1 1 1 1 1 8 3 7 1 1 1 1 1 1 1 1 16 16 16 16 16 16 16 16 16 16 16 16 16 1 1 1 1 1 20 21 31 18 18 18 18 
18 18 18 18 18 18 18 30 22 1 1 1 1 1 14 5 15 1 1 1 1 1 1 1 1 1 1 1 16 16 16 16 16 16 16 16 16 1 1 1 1 1 1 23 18 18 18 18 18 18 
18 18 18 18 18 18 18 18 30 21 22 1 1 1 1 1 1 1 1 1 1 1 1 1 1 1 1 1 1 16 16 16 16 1 1 1 1 1 1 1 1 1 20 31 18 18 18 18 18 18 
18 18 18 18 18 18 18 18 18 18 30 22 1 1 1 1 1 1 1 1 1 1 1 1 1 1 1 1 1 1 1 1 1 1 1 1 1 1 1 1 20 21 31 18 18 18 18 18 18 18 
18 18 18 18 18 18 18 18 18 18 18 30 21 21 21 21 21 21 21 21 21 21 21 22 1 1 1 1 1 1 1 1 1 1 1 20 21 21 21 21 31 18 18 18 18 18 18 18 18 18 
18 18 18 18 18 18 18 18 18 18 18 18 18 18 18 18 18 18 18 18 18 18 18 30 21 21 21 21 21 21 21 21 21 21 21 31 18 18 18 18 18 18 18 18 18 18 18 18 18 18 
18 18 18 18 18 18 18 18 18 18 18 18 18 18 18 18 18 18 18 18 18 18 18 18 18 18 18 18 18 18 18 18 18 18 18 18 18 18 18 18 18 18 18 18 18 18 18 18 18 18 
18 18 18 18 18 18 18 18 18 18 18 18 18 18 18 18 18 18 18 18 18 18 18 18 18 18 18 18 18 18 18 18 18 18 18 18 18 18 18 18 18 18 18 18 18 18 18 18 18 18 
18 18 18 18 18 18 18 18 18 18 18 18 18 18 18 18 18 18 18 18 18 18 18 18 18 18 18 18 18 18 18 18 18 18 18 18 18 18 18 18 18 18 18 18 18 18 18 18 18 18 
18 18 18 18 18 18 18 18 18 18 18 18 18 18 18 18 18 18 18 18 18 18 18 18 18 18 18 18 18 18 18 18 18 18 18 18 18 18 18 18 18 18 18 18 18 18 18 18 18 18 
18 18 18 18 18 18 18 18 18 18 18 18 18 18 18 18 18 18 18 18 18 18 18 18 18 18 18 18 18 18 18 18 18 18 18 18 18 18 18 18 18 18 18 18 18 18 18 18 18 18 
18 18 18 18 18 18 18 18 18 18 18 18 18 18 18 18 18 18 18 18 18 18 18 18 18 18 18 18 18 18 18 18 18 18 18 18 18 18 18 18 18 18 18 18 18 18 18 18 18 18 
18 18 18 18 18 18 18 18 18 18 18 18 18 18 18 18 18 18 18 18 18 18 18 18 18 18 18 18 18 18 18 18 18 18 18 18 18 18 18 18 18 18 18 18 18 18 18 18 18 18 
18 18 18 18 18 18 18 18 18 18 18 18 18 18 18 18 18 18 18 18 18 18 18 18 18 18 18 18 18 18 18 18 18 18 18 18 18 18 18 18 18 18 18 18 18 18 18 18 18 18 
18 18 18 18 18 18 18 18 18 18 18 18 18 18 18 18 18 18 18 18 18 18 18 18 18 18 18 18 18 18 18 18 18 18 18 18 18 18 18 18 18 18 18 18 18 18 18 18 18 18 
18 18 18 18 18 18 18 18 18 18 18 18 18 18 18 18 18 18 18 18 18 18 18 18 18 18 18 18 18 18 18 18 18 18 18 18 18 18 18 18 18 18 18 18 18 18 18 18 18 18 
18 18 18 18 18 18 18 18 18 18 18 18 18 18 18 18 18 18 18 18 18 18 18 18 18 18 18 18 18 18 18 18 18 18 18 18 18 18 18 18 18 18 18 18 18 18 18 18 18 18 
