9 9 9 9 9 9 9 9 9 9 9 9 9 9 9 9 9 9 9 9 11 2 2 2 2 2 15 9 9 9 9 9 9 9 9 9 9 9 9 9 9 9 9 9 9 9 9 9 9 9 
4 1 1 1 1 1 1 1 1 1 4 4 4 4 4 4 4 4 4 4 10 9 11 2 2 15 14 0 0 0 0 0 4 4 4 4 4 1 1 1 1 1 1 1 1 1 1 1 1 4
4 1 0 0 0 0 0 0 0 1 4 4 4 4 4 4 4 4 0 0 0 0 12 2 2 13 0 0 0 0 3 0 3 3 4 4 4 4 4 4 1 3 3 3 1 3 3 3 1 4
4 1 0 0 0 0 0 0 0 1 1 1 1 4 4 0 4 0 0 0 0 0 12 2 2 13 0 0 0 0 0 0 0 0 0 4 4 4 4 4 1 3 3 3 1 3 1 3 1 4
4 1 0 0 0 0 0 0 0 0 0 0 1 4 4 0 0 0 0 0 0 0 12 2 2 13 0 0 3 0 3 0 3 3 0 3 4 1 1 1 1 3 3 3 3 3 1 3 1 4
4 1 0 0 0 0 0 0 0 0 0 0 1 4 0 0 0 0 0 0 0 0 12 2 2 13 0 0 0 3 0 3 3 3 3 1 1 1 1 1 1 1 1 1 1 1 1 3 1 4
4 1 1 1 1 1 1 1 1 1 0 1 1 4 0 0 0 0 0 0 0 0 12 2 2 13 0 3 0 0 0 3 3 3 3 1 3 3 3 1 3 3 3 1 3 3 3 3 1 4
4 3 3 3 3 3 3 3 3 3 3 3 3 3 3 3 3 3 3 3 3 3 12 2 2 13 0 0 3 0 3 3 3 3 3 1 3 1 3 3 3 1 3 3 3 1 3 3 1 4
4 4 4 4 4 4 4 4 4 4 3 0 0 0 0 0 0 0 0 0 0 3 12 2 2 13 0 0 0 3 0 3 3 3 3 1 3 1 1 1 1 1 1 1 1 1 1 1 1 4
4 4 4 4 4 4 4 4 4 4 3 0 0 0 0 0 0 0 0 0 0 3 12 2 2 13 0 0 3 0 3 3 3 3 3 3 3 3 3 3 3 3 3 3 3 3 3 3 3 4
4 4 4 4 4 4 4 4 4 4 3 0 0 0 0 0 0 0 0 0 0 3 3 3 3 3 3 3 3 3 3 3 3 3 3 3 3 3 3 3 3 3 3 3 3 3 3 3 4
4 4 4 1 1 1 1 1 4 4 3 0 0 0 0 0 0 0 0 0 0 3 3 3 3 3 3 3 3 3 3 3 3 3 3 3 3 3 3 3 3 3 3 3 3 3 3 3 4
4 4 4 1 8 8 6 1 4 4 3 0 0 0 0 0 0 0 0 0 0 0 12 2 2 13 3 3 3 3 3 3 3 3 3 3 3 3 1 1 1 1 1 1 1 3 3 3 4
4 4 4 1 8 8 8 1 4 4 3 0 0 0 0 0 0 0 0 0 0 0 12 2 2 13 3 3 3 3 3 3 3 3 3 3 3 3 1 5 3 5 3 5 1 3 3 3 4
4 4 4 1 8 8 8 1 4 4 3 0 0 0 0 0 0 0 0 0 0 0 12 2 2 13 3 3 3 3 3 3 3 3 3 3 3 3 1 3 5 3 5 3 1 3 3 3 4
4 4 4 1 1 7 1 1 4 4 3 0 0 0 0 0 0 0 0 0 0 0 12 2 2 13 3 3 3 3 3 3 3 3 3 3 3 3 1 5 3 5 3 5 1 3 3 3 4
4 4 4 4 4 3 3 3 3 3 3 0 0 0 0 0 0 0 0 0 0 0 12 2 2 13 3 3 3 3 3 3 3 3 3 3 3 3 1 3 5 3 5 3 1 3 3 3 4
4 4 4 4 0 0 0 0 0 0 0 0 0 0 0 0 0 0 0 0 0 0 12 2 2 13 3 3 3 3 3 3 3 3 3 3 3 3 1 5 3 5 3 5 1 3 3 3 4
4 0 0 0 0 0 0 0 0 0 0 0 0 0 0 0 0 0 0 0 0 0 12 2 2 13 3 3 3 3 3 3 3 3 3 3 3 3 1 3 1 1 1 1 1 3 3 3 4
4 0 0 0 0 0 0 0 0 0 0 0 0 0 0 0 0 0 0 0 0 0 12 2 2 13 3 3 3 3 3 3 3 3 3 3 3 3 3 3 3 3 3 3 3 3 3 3 4
4 0 0 0 0 0 0 0 0 0 0 0 0 0 0 0 0 0 0 0 0 0 12 2 2 13 3 3 3 3 1 3 3 3 3 3 3 3 3 3 3 3 3 3 3 3 3 3 4
4 0 0 0 0 0 0 0 0 0 0 0 0 0 0 0 0 0 0 0 0 0 12 2 2 13 3 3 3 3 3 3 3 3 3 3 3 3 3 3 3 3 3 3 3 3 3 3 4
4 0 0 0 0 0 0 0 0 0 0 0 0 0 0 0 0 0 0 0 0 0 12 2 2 13 3 3 3 3 3 3 3 3 3 3 3 3 3 3 3 3 3 3 3 1 3 3 4
4 0 0 0 0 0 0 0 0 0 0 0 0 0 0 0 0 0 0 0 0 0 12 2 2 13 3 3 3 3 3 3 3 3 3 3 3 3 3 3 3 3 3 3 3 3 3 3 4
4 0 0 0 0 0 0 0 0 0 0 0 0 0 0 0 0 0 0 0 0 0 12 2 2 13 3 3 3 3 3 3 3 3 3 3 3 3 3 3 3 3 3 3 3 3 3 3 4
4 5 5 5 5 5 5 5 5 5 5 5 5 5 5 5 5 5 5 5 5 5 12 2 2 13 0 0 0 0 0 0 0 0 0 0 0 0 0 0 0 0 0 0 0 0 0 0 4
4 5 5 5 5 5 5 5 5 5 5 5 5 5 5 5 5 5 5 5 5 5 12 2 2 13 0 0 0 0 0 0 0 0 0 0 0 0 0 0 0 0 0 0 0 0 0 4
4 5 5 5 5 5 5 5 5 5 5 5 5 5 5 5 5 5 5 5 5 5 12 2 2 13 0 0 0 0 0 0 0 0 0 0 0 0 0 0 0 0 0 0 0 0 0 4
4 5 5 5 5 4 5 5 5 5 5 5 5 5 5 5 5 5 5 5 5 5 12 2 2 13 0 0 0 0 4 4 4 4 4 0 0 0 0 0 0 0 0 0 0 0 0 0 4
4 5 5 5 5 5 5 5 5 5 5 5 5 5 5 5 5 5 5 5 5 5 12 2 2 13 0 0 0 0 4 4 4 4 4 0 0 0 0 0 0 0 0 0 0 0 0 0 4
4 5 5 5 5 5 5 5 5 5 5 5 5 5 5 5 5 5 5 5 5 5 12 2 2 13 0 0 0 0 4 4 4 4 4 0 0 0 0 0 0 0 0 0 0 0 0 0 4
4 5 5 5 5 5 5 5 5 5 5 5 5 5 5 5 5 5 5 5 5 5 12 2 2 13 0 0 0 0 4 4 4 4 4 0 0 0 0 0 0 0 0 0 0 0 0 0 4
4 5 5 5 5 5 5 5 5 5 5 5 5 5 5 5 5 5 5 5 5 5 12 2 2 13 0 0 0 0 4 4 4 4 4 0 0 0 0 0 0 0 0 0 0 0 0 0 4
4 5 5 5 5 5 5 5 5 5 5 5 5 5 5 5 5 5 5 5 5 5 12 2 2 13 0 0 0 0 0 0 0 0 0 0 0 0 0 0 0 0 0 0 0 0 0 0 4
4 5 5 5 5 5 5 5 4 4 4 4 4 5 5 5 5 5 5 5 5 5 12 2 2 13 0 0 0 0 0 0 0 0 0 0 0 0 0 0 0 0 0 0 0 0 0 0 4
4 5 5 5 5 5 5 5 4 2 2 2 4 5 5 5 5 5 5 5 5 5 12 3 3 13 0 0 0 0 0 0 0 0 0 0 0 0 0 0 0 0 0 0 0 0 0 0 4
4 5 5 5 5 5 5 5 4 2 2 2 4 5 5 5 5 5 5 5 5 5 12 3 3 13 0 0 0 0 0 0 0 0 0 0 0 0 0 0 0 0 0 0 0 0 0 0 4
4 5 5 5 5 5 5 5 4 2 2 2 4 5 5 5 5 5 5 5 5 5 12 2 2 13 0 0 0 0 0 0 0 0 0 0 0 0 0 0 0 0 0 0 0 0 0 0 4
4 5 5 5 5 5 5 5 4 4 4 4 4 5 5 5 5 5 5 5 5 5 12 2 2 13 0 0 4 0 0 0 0 0 0 0 0 0 0 0 0 0 0 0 0 0 0 0 4
4 5 5 5 5 5 5 5 5 5 5 5 5 5 5 5 5 5 5 5 5 5 12 2 2 13 0 0 0 0 0 0 0 0 0 0 0 0 0 0 0 0 0 0 0 0 0 0 4
4 5 5 5 5 5 5 5 5 5 5 5 5 5 5 5 5 5 5 5 5 5 12 2 2 13 0 0 0 0 0 0 0 0 0 0 0 0 0 0 0 0 0 0 0 0 0 0 4
4 5 5 5 5 5 5 5 5 5 5 5 5 5 5 5 5 5 5 5 5 5 12 2 2 13 0 0 0 0 0 0 0 0 0 0 0 0 0 0 0 0 0 0 0 0 0 0 4
4 5 5 5 5 5 5 5 5 5 5 5 5 5 5 5 5 5 5 5 5 5 12 2 2 13 0 0 0 0 0 0 0 0 0 0 0 0 4 4 4 4 4 4 4 4 0 0 4
4 5 5 5 5 5 5 5 5 5 5 5 5 5 5 5 5 5 5 5 5 5 12 2 2 13 0 0 0 0 0 0 0 0 0 0 0 0 4 4 4 4 4 4 4 4 0 0 4
4 5 5 5 5 5 5 5 5 5 5 5 5 5 5 5 5 5 5 5 5 5 12 2 2 13 0 0 0 0 0 0 0 0 0 0 0 0 4 4 4 4 4 4 4 4 0 0 4
4 5 5 5 5 5 5 5 5 5 5 5 5 5 5 5 5 5 4 5 5 5 12 2 2 13 0 0 0 0 0 0 0 0 0 0 0 0 4 4 4 4 4 4 4 4 0 0 4
4 5 5 5 5 5 5 5 5 5 5 5 5 5 5 5 5 5 5 5 5 5 12 2 2 13 0 0 0 0 0 0 0 0 0 0 0 0 4 4 4 4 4 4 4 4 0 0 4
4 5 5 5 5 5 5 5 5 5 5 5 5 5 5 5 5 5 5 5 5 5 12 2 2 13 0 0 0 0 0 0 0 0 0 0 0 0 0 0 0 0 0 0 0 0 0 0 4
4 5 5 5 5 5 5 5 5 5 5 5 5 5 5 5 5 5 5 5 5 5 12 2 2 13 0 0 0 0 0 0 0 0 0 0 0 0 0 0 0 0 0 0 0 0 0 0 4
4 4 4 4 4 4 4 4 4 4 4 4 4 4 4 4 4 4 4 4 4 4 2 2 2 3 4 4 4 4 4 4 4 4 4 4 4 4 4 4 4 4 4 4 4 4 4 4 4 4